"a" = (/turf/template_noop,/area/template_noop)
"b" = (/obj/structure/landmine/blue,/turf/simulated/floor/dirty/indestructable,/area/template_noop)
"c" = (/obj/structure/defensive_barrier{pixel_y = -4; secured = 1},/obj/effect/map_entity/nodraw,/turf/simulated/wall/perspecticrete,/area/template_noop)
"f" = (/turf/simulated/floor/concrete/random,/area/template_noop)
"h" = (/obj/structure/trench_wall{dir = 6},/turf/simulated/mineral{health = 999999},/area/template_noop)
"i" = (/obj/structure/dirt_wall,/turf/simulated/floor/dirty/indestructable,/area/warfare/battlefield/capture_point/mid)
"j" = (/obj/machinery/light/streetlamp/floodlamp/short/auto,/turf/simulated/floor/dirty/indestructable,/area/warfare/battlefield/capture_point/mid)
"m" = (/turf/simulated/floor/dirty/indestructable,/area/template_noop)
"o" = (/turf/simulated/mineral{health = 999999},/area/template_noop)
"p" = (/obj/structure/trench_wall{dir = 8},/turf/simulated/mineral{health = 999999},/area/template_noop)
"q" = (/obj/machinery/door/airlock/multi_tile/metal/maintenance/red,/turf/simulated/wall/perspecticrete,/area/template_noop)
"r" = (/obj/structure/barbwire,/turf/simulated/floor/dirty/indestructable,/area/warfare/battlefield/capture_point/mid)
"s" = (/obj/effect/map_entity/environment_blocker,/turf/simulated/wall/perspecticrete,/area/warfare/battlefield/capture_point/mid)
"t" = (/obj/structure/landmine/red,/turf/simulated/floor/dirty/indestructable,/area/template_noop)
"v" = (/turf/simulated/wall/perspecticrete,/area/template_noop)
"w" = (/obj/machinery/door/airlock/multi_tile/metal/maintenance/blue,/turf/space,/area/template_noop)
"x" = (/obj/structure/defensive_barrier{dir = 1; pixel_y = 12; secured = 1},/obj/effect/map_entity/nodraw,/turf/simulated/wall/perspecticrete{layer = 29; plane = -150},/area/template_noop)
"A" = (/obj/structure/trench_wall/sequel{dir = 4},/turf/simulated/mineral{health = 999999},/area/template_noop)
"D" = (/obj/structure/trench_wall/sequel{dir = 8},/turf/simulated/mineral{health = 999999},/area/template_noop)
"E" = (/obj/structure/barbwire,/turf/simulated/floor/dirty/indestructable,/area/template_noop)
"H" = (/turf/simulated/floor/dirty/indestructable,/area/warfare/battlefield/capture_point/mid)
"I" = (/obj/structure/trench_wall{dir = 10},/turf/simulated/mineral{health = 999999},/area/template_noop)
"K" = (/obj/structure/trench_wall{dir = 4},/turf/simulated/mineral{health = 999999},/area/template_noop)
"M" = (/obj/effect/phone_line,/turf/template_noop,/area/template_noop)
"Q" = (/obj/structure/dirt_wall,/turf/simulated/floor/dirty/indestructable,/area/template_noop)
"R" = (/turf/simulated/floor/trench,/area/warfare/battlefield/capture_point/mid)
"T" = (/obj/machinery/light/small/red{dir = 8; pixel_y = 6; pixel_x = -7},/turf/simulated/floor/concrete/random,/area/template_noop)
"W" = (/turf/space,/area/template_noop)

(1,1,1) = {"
aaaaaaaaaaaaaaaaaaaaaaaaaaaaaaaaaaaaaaaaaaaaaaaa
aaaaaaaaaaaaaaaaaaaaaaaaaaaaaaaaaaaaaaaaaaaaaaaa
aaaaaaaaaaaaaaaaaaaaaaaaaaaaaaaaaaaaaaaaaaaaaaaa
aaaaaaaaaaaaaaaaaaaaaaaaaaaaaaaaaaaaaaaaaaaaaaaa
aaaaaaaaaaaaaaaaaaaaaaaaaaaaaaaaaaaaaaaaaaaaaaaa
aaaaaaaaaaaaaaaaaaaaaaaaaaaaaaaaaaaaaaaaaaaaaaaa
aaaaaaaaaaaaaaaaaaaaaaaaaaaaaaaaaaaaaaaaaaaaaaaa
aaaaaaaaaaaaaaaaaaaaaaaaaaaaaaaaaaaaaaaaaaaaaaaa
aaaaaaaaaaaaaaaaaaaaaaaaaaaaaaaaaaaaaaaaaaaaaaaa
aaaaaaaaaaaaaaaaaaaaaaaaaaaaaaaaaaaaaaaaaaaaaaaa
aaaaaaaaaaaaaaaaaaaaaaaaaaaaaaaaaaaaaaaaaaaaaaaa
aaaaaaaaaaaaaaaaaaaaaaaaaaaaaaaaaaaaaaaaaaaaaaaa
aaaaaaaaaaaaaaaaaaaaaaaaaaaaaaaaaaaaaaaaaaaaaaaa
aaaaaaaaaaaaaaaaaaaaaaaaaaaaaaaaaaaaaaaaaaaaaaaa
aaaaaaaaaaaaaaaaaaaaaaaaaaaaaaaaaaaaaaaaaaaaaaaa
aaaaaaaaaaaaaaaaaaaaaaaaaaaaaaaaaaaaaaaaaaaaaaaa
aaaaaaaaaaaaaaaaaaaaaaaaaaaaaaaaaaaaaaaaaaaaaaaa
aaaaaaaaaaaaaaaaaaaaaaaaaaaaaaaaaaaaaaaaaaaaaaaa
aaaaaaaaaaaaaaaaaaaaaaaaaaaaaaaaaaaaaaaaaaaaaaaa
aaaaaaaaaaaaaaaaaaaaaaaaaaaaaaaaaaaaaaaaaaaaaaaa
aaaaaaaaaaaaaaaaaaaaaaaaaaaaaaaaaaaaaaaaaaaaaaaa
aaaaaaaaaaaaaaaaaaaaaaaaaaaaaaaaaaaaaaaaaaaaaaaa
aaaaaaaaaaaaaaaaaaaaaaaaaaaaaaaaaaaaaaaaaaaaaaaa
aaaaaaaaaaaaaaaaaaaaaaaaaaaaaaaaaaaaaaaaaaaaaaaa
aaaaaaaaaaaaaaaaaaaaaaaaaaaaaaaaaaaaaaaaaaaaaaaa
aaaaaaaaaaaaaaaaaaaaaaaaaaaaaaaaaaaaaaaaaaaaaaaa
aaaaaaaaaaaaaaaaaaaaaaaaaaaaaaaaaaaaaaaaaaaaaaaa
aaaaaaaaaaaaaaaaaaaaaaaaaaaaaaaaaaaaaaaaaaaaaaaa
aaaaaaaaaaaaaaaaaaaaaaaaaaaaaaaaaaaaaaaaaaaaaaaa
aaaaaaaaaaaaaaaaaaaaaaaaaaaaaaaaaaaaaaaaaaaaaaaa
aaaaaaaaaaaaaaaaaaaaaaaaaaaaaaaaaaaaaaaaaaaaaaaa
aaaaaaaaaaaaaaaaaaaaaaaaaaaaaaaaaaaaaaaaaaaaaaaa
aaaaaaaaaaaaaaaaaaaaaaaaaaaaaaaaaaaaaaaaaaaaaaaa
aaaaaaaaaaaaaaaaaaaaaaaaaaaaaaaaaaaaaaaaaaaaaaaa
aaaaaaaaaaaaaaaaaaaaaaaaaaaaaaaaaaaaaaaaaaaaaaaa
aaaaaaaaaaaaaaaaaaaaaaaaaaaaaaaaaaaaaaaaaaaaaaaa
aaaaaaaaaaaaaaaaaaaaaaaaaaaaaaaaaaaaaaaaaaaaaaaa
aaaaaaaaaaaaaaaaaaaaaaaaaaaaaaaaaaaaaaaaaaaaaaaa
aaaaaaaaaaaaaaaaaaaaaaaaaaaaaaaaaaaaaaaaaaaaaaaa
aaaaaaaaaaaaaaaaaaaaaaaaaaaaaaaaaaaaaaaaaaaaaaaa
aaaaaaaaaaaaaaaaaaaaaaaaaaaaaaaaaaaaaaaaaaaaaaaa
aaaaaaaaaaaaaaaaaaaaaaaaaaaaaaaaaaaaaaaaaaaaaaaa
aaaaaaaaaaaaaaaaaaaaaaaaaaaaaaaaaaaaaaaaaaaaaaaa
aaaaaaaaaaaaaaaaaaaaaaaaaaaaaaaaaaaaaaaaaaaaaaaa
aaaaaaaaaaaaaaaaaaaaaaaaaaaaaaaaaaaaaaaaaaaaaaaa
aaaaaaaaaaaaaaaaaaaaaaaaaaaaaaaaaaaaaaaaaaaaaaaa
aaaaaaaaaaaaaaaaaaaaaaaaaaaaaaaaaaaaaaaaaaaaaaaa
aaaaaaaaaaaaaaaaaaaaaaaaaaaaaaaaaaaaaaaaaaaaaaaa
aaaaaaaaaaaaaaaaaaaaaaaaaaaaaaaaaaaaaaaaaaaaaaaa
aaaaaaaaaaaaaaaaaaaaaaaaaaaaaaaaaaaaaaaaaaaaaaaa
aaaaaaaaaaaaaaaaaaaaaaaaaaaaaaaaaaaaaaaaaaaaaaaa
aaaaaaaaaaaaaaaaaaaaaaaaaaaaaaaaaaaaaaaaaaaaaaaa
aaaaaaaaaaaaaaaaaaaaaaaaaaaaaaaaaaaaaaaaaaaaaaaa
aaaaaaaaaaaaaaaaaaaaaaaaaaaaaaaaaaaaaaaaaaaaaaaa
aaaaaaaaaaaaaaaaaaaaaaaaaaaaaaaaaaaaaaaaaaaaaaaa
aaaaaaaaaaaaaaaaaaaaaaaaaaaaaaaaaaaaaaaaaaaaaaaa
aaaaaaaaaaaaaaaaaaaaaaaaaaaaaaaaaaaaaaaaaaaaaaaa
aaaaaaaaaaaaaaaaaaaaaaDxxAaaaaaaaaaaaaaaaaaaaaaa
aaaaaaaaaaaaaaaaaaaaaaoffoaaaaaaaaaaaaaaaaaaaaaa
aaaaaaaaaaaaaaaaaaaaaaowWoaaaaaaaaaaaaaaaaaaaaaa
aaaaaaaaaaaaaaaaaaaaaaaaaaaaaaaaaaaaaaaaaaaaaaaa
aaaaaaaaaaaaaaaaaaaaaaaaaaaaaaaaaaaaaaaaaaaaaaaa
aaaaaaaaaaaaaaaaaaaaaaaaaaaaaaaaaaaaaaaaaaaaaaaa
aaaaaaaaaaaaaaaaaaaaaaaaaaaaaaaaaaaaaaaaaaaaaaaa
aaaaaaaaaaaaaaaaaaaaaaaaaaaaaaaaaaaaaaaaaaaaaaaa
aaaaaaaaaaaaaaaaaaaaaaaaaaaaaaaaaaaaaaaaaaaaaaaa
aaaaaaaaaaaaaaaaaaaaaaaaaaaaaaaaaaaaaaaaaaaaaaaa
aaaaaaaaaaaaaaaaaaaaaaaaaaaaaaaaaaaaaaaaaaaaaaaa
aaaaaaaaaaaaaaaaaaaaaaaaaaaaaaaaaaaaaaaaaaaaaaaa
aaaaaaaaaaaaaaaaaaaaaaaaaaaaaaaaaaaaaaaaaaaaaaaa
aaaaaaaaaaaaaaaaaaaaaaaaaaaaaaaaaaaaaaaaaaaaaaaa
aaaaaaaaaaaaaaaaaaaaaaaaaaaaaaaaaaaaaaaaaaaaaaaa
aaaaaaaaaaaaaaaaaaaaaaaaaaaaaaaaaaaaaaaaaaaaaaaa
aaaaaaaaaaaaaaaaaaaaaaaaaaaaaaaaaaaaaaaaaaaaaaaa
aaaaaaaaaaaaaaaaaaaaaaaaaaaaaaaaaaaaaaaaaaaaaaaa
aaaaaaaaaaaaaaaaaaaaaaaaaaaaaaaaaaaaaaaaaaaaaaaa
aaaaaaaaaaaaaaaaaaaaaaaaaaaaaaaaaaaaaaaaaaaaaaaa
aaaaaaaaaaaaaaaaaaaaaaaaaaaaaaaaaaaaaaaaaaaaaaaa
aaaaaaaaaaaaaaaaaaaaaaaaaaaaaaaaaaaaaaaaaaaaaaaa
aaaaaaaaaaaaaaaaaaaaaaaaaaaaaaaaaaaaaaaaaaaaaaaa
aaaaaaaaaaaaaaaaaaaaaaaaaaaaaaaaaaaaaaaaaaaaaaaa
aaaaaaaaaaaaaaaaaaaaaaaaaaaaaaaaaaaaaaaaaaaaaaaa
aaaaaaaaaaaaaaaaaaaaaaaaaaaaaaaaaaaaaaaaaaaaaaaa
aaaaaaaaaaaaaaaaaaaaaaaaaaaaaaaaaaaaaaaaaaaaaaaa
aaaaaaaaaaaaaaaaaaaaaaaaaaaaaaaaaaaaaaaaaaaaaaaa
aaaaaaaaaaaaaaaaaaaaaaaaaaaaaaaaaaaaaaaaaaaaaaaa
aaaaaaaaaaaaaaaaaaaaaaaaaaaaaaaaaaaaaaaaaaaaaaaa
aaaaaaaaaaaaaaaaaaaaaaaaaaaaaaaaaaaaaaaaaaaaaaaa
aaaaaaaaaaaaaaaaaaaaaaaaaaaaaaaaaaaaaaaaaaaaaaaa
aaaaaaaaaaaaaaaaaaaaaaaaaaaaaaaaaaaaaaaaaaaaaaaa
aaaaaaaaaaaaaaaaaaaaaaaaaaaaaaaaaaaaaaaaaaaaaaaa
aaaaaaaaaaaaaaaaaaaaaaaaaaaaaaaaaaaaaaaaaaaaaaaa
aaaaaaaaaaaaaaaaaaaaaaaaaaaaaaaaaaaaaaaaaaaaaaaa
aaaaaaaaaaaaaaaaaaaaaaaaaaaaaaaaaaaaaaaaaaaaaaaa
aaaaaaaaaaaaaaaaaaaaaaaaaaaaaaaaaaaaaaaaaaaaaaaa
aaaaaaaaaaaaaaaaaaaaaaaaaaaaaaaaaaaaaaaaaaaaaaaa
aaaaaaaaaaaaaaaaaaaaaaaaaaaaaaaaaaaaaaaaaaaaaaaa
aaaaaaaaaaaaaaaaaaaaaaaaaaaaaaaaaaaaaaaaaaaaaaaa
aaaaaaaaaaaaaaaaaaaaaaaaaaaaaaaaaaaaaaaaaaaaaaaa
aaaaaaaaaaaaaaaaaaaaaaaaaaaaaaaaaaaaaaaaaaaaaaaa
aaaaaaaaaaaaaaaaaaaaaaaaaaaaaaaaaaaaaaaaaaaaaaaa
aaaaaaaaaaaaaaaaaaaaaaaaaaaaaaaaaaaaaaaaaaaaaaaa
aaaaaaaaaaaaaaaaaaaaaaaaaaaaaaaaaaaaaaaaaaaaaaaa
aaaaaaaaaaaaaaaaaaaaaaaaaaaaaaaaaaaaaaaaaaaaaaaa
aaaaaaaaaaaaaaaaaaaaaaaaaaaaaaaaaaaaaaaaaaaaaaaa
aaaaaaaaaaaaaaaaaaaaaaaaaaaaaaaaaaaaaaaaaaaaaaaa
aaaaaaaaaaaaaaaaaaaaaaaaaaaaaaaaaaaaaaaaaaaaaaaa
aaaaaaaaaaaaaaaaaaaaaaaaaaaaaaaaaaaaaaaaaaaaaaaa
aaaaaaaaaaaaaaaaaaaaaaaaaaaaaaaaaaaaaaaaaaaaaaaa
aaaaaaaaaaaaaaaaaaaaaaaaaaaaaaaaaaaaaaaaaaaaaaaa
aaaaaaaaaaaaaaaaaaaaaaaaaaaaaaaaaaaaaaaaaaaaaaaa
aaaaaaaaaaaaaaaaaaaaaaaaaaaaaaaaaaaaaaaaaaaaaaaa
aaaaaaaaaaaaaaaaaaaaaaaaaaaaaaaaaaaaaaaaaaaaaaaa
aaaaaaaaaaaaaaaaaaaaaaaaaaaaaaaaaaaaaaaaaaaaaaaa
aaaaaaaaaaaaaaaaaaaaaaaaaaaaaaaaaaaaaaaaaaaaaaaa
aaaaaaaaaaaaaaaaaaaaaaaaaaaaaaaaaaaaaaaaaaaaaaaa
aaaaaaaaaaaaaaaaaaaaaaaaaaaaaaaaaaaaaaaaaaaaaaaa
aaaaaaaaaaaaaaaaaaaaaaaaaaaaaaaaaaaaaaaaaaaaaaaa
aaaaaaaaaaaaaaaaaaaaaaaaaaaaaaaaaaaaaaaaaaaaaaaa
aaaaaaaaaaaaaaaaaaaaaaaaaaaaaaaaaaaaaaaaaaaaaaaa
aaaaaaaaaaaaaaaaaaaaaaaaaaaaaaaaaaaaaaaaaaaaaaaa
aaaaaaaaaaaaaaaaaaaaaaaaaaaaaaaaaaaaaaaaaaaaaaaa
aaaaaaaaaaaaaaaaaaaaaaaaaaaaaaaaaaaaaaaaaaaaaaaa
aaaaaaaaaaaaaaaaaaaaaaaaaaaaaaaaaaaaaaaaaaaaaaaa
aaaaaaaaaaaaaaaaaaaaaaaaaaaaaaaaaaaaaaaaaaaaaaaa
aaaaaaaaaaaaaaaaaaaaaaaaaaaaaaaaaaaaaaaaaaaaaaaa
aaaaaaaaaaaaaaaaaaaaaaaaaaaaaaaaaaaaaaaaaaaaaaaa
aaaaaaaaaaaaaaaaaaaaaaaaaaaaaaaaaaaaaaaaaaaaaaaa
aaaaaaaaaaaaaaaaaaaaaaaaaaaaaaaaaaaaaaaaaaaaaaaa
aaaaaaaaaaaaaaaaaaaaaaaaaaaaaaaaaaaaaaaaaaaaaaaa
aaaaaaaaaaaaaaaaaaaaaaaaaaaaaaaaaaaaaaaaaaaaaaaa
aaaaaaaaaaaaaaaaaaaaaaaaaaaaaaaaaaaaaaaaaaaaaaaa
aaaaaaaaaaaaaaaaaaaaaaaaaaaaaaaaaaaaaaaaaaaaaaaa
aaaaaaaaaaaaaaaaaaaaaaaaaaaaaaaaaaaaaaaaaaaaaaaa
aaaaaaaaaaaaaaaaaaaaaaaaaaaaaaaaaaaaaaaaaaaaaaaa
aaaaaaaaaaaaaaaaaaaaaaaaaaaaaaaaaaaaaaaaaaaaaaaa
aaaaaaaaaaaaaaaaaaaaaaaaaaaaaaaaaaaaaaaaaaaaaaaa
aaaaaaaaaaaaaaaaaaaaaaaaaaaaaaaaaaaaaaaaaaaaaaaa
aaaaaaaaaaaaaaaaaaaaaaaaaaaaaaaaaaaaaaaaaaaaaaaa
aaaaaaaaaaaaaaaaaaaaaaaaaaaaaaaaaaaaaaaaaaaaaaaa
aaaaaaaaaaaaaaaaaaaaaaaaaaaaaaaaaaaaaaaaaaaaaaaa
aaaaaaaaaaaaaaaaaaaaaaaaaaaaaaaaaaaaaaaaaaaaaaaa
aaaaaaaaaaaaaaaaaaaaaaaaaaaaaaaaaaaaaaaaaaaaaaaa
aaaaaaaaaaaaaaaaaaaaaaaaaaaaaaaaaaaaaaaaaaaaaaaa
aaaaaaaaaaaaaaaaaaaaaaaaaaaaaaaaaaaaaaaaaaaaaaaa
aaaaaaaaaaaaaaaaaaaaaaaaaaaaaaaaaaaaaaaaaaaaaaaa
aaaaaaaaaaaaaaaaaaaaaaaaaaaaaaaaaaaaaaaaaaaaaaaa
aaaaaaaaaaaaaaaaaaaaaaaaaaaaaaaaaaaaaaaaaaaaaaaa
aaaaaaaaaaaaaaaaaaaaaaaaaaaaaaaaaaaaaaaaaaaaaaaa
aaaaaaaaaaaaaaaaaaaaaaaaaaaaaaaaaaaaaaaaaaaaaaaa
aaaaaaaaaaaaaaaaaaaaaaaaaaaaaaaaaaaaaaaaaaaaaaaa
aaaaaaaaaaaaaaaaaaaaaaaaaaaaaaaaaaaaaaaaaaaaaaaa
aaaaaaaaaaaaaaaaaaaaaaaaaaaaaaaaaaaaaaaaaaaaaaaa
aaaaaaaaaaaaaaaaaaaaaaaaaaaaaaaaaaaaaaaaaaaaaaaa
aaaaaaaaaaaaaaaaaaaaaaaaaaaaaaaaaaaaaaaaaaaaaaaa
aaaaaaaaaaaaaaaaaaaaaaaaaaaaaaaaaaaaaaaaaaaaaaaa
aaaaaaaaaaaaaaaaaaaaaaaaaaaaaaaaaaaaaaaaaaaaaaaa
aaaaaaaaaaaaaaaaaaaaaaaaaaaaaaaaaaaaaaaaaaaaaaaa
aaaaaaaaaaaaaaaaaaaaaaaaaaaaaaaaaaaaaaaaaaaaaaaa
aaaaaaaaaaaaaaaaaaaaaaaaaaaaaaaaaaaaaaaaaaaaaaaa
aaaaaaaaaaaaaaaaaaaaaaaaaaaaaaaaaaaaaaaaaaaaaaaa
aaaaaaaaaaaaaaaaaaaaaaaaaaaaaaaaaaaaaaaaaaaaaaaa
aaaaaaaaaaaaaaaaaaaaaaaaaaaaaaaaaaaaaaaaaaaaaaaa
aaaaaaaaaaaaaaaaaaaaaaaaaaaaaaaaaaaaaaaaaaaaaaaa
aaaaaaaaaaaaaaaaaaaaaaaaaaaaaaaaaaaaaaaaaaaaaaaa
aaaaaaaaaaaaaaaaaaaaaaaaaaaaaaaaaaaaaaaaaaaaaaaa
aaaaaaaaaaaaaaaaaaaaaaaaaaaaaaaaaaaaaaaaaaaaaaaa
aaaaaaaaaaaaaaaaaaaaaaaaaaaaaaaaaaaaaaaaaaaaaaaa
aaaaaaaaaaaaaaaaaaaaaaaaaaaaaaaaaaaaaaaaaaaaaaaa
aaaaaaaaaaaaaaaaaaaaaaaaaaaaaaaaaaaaaaaaaaaaaaaa
aaaaaaaaaaaaaaaaaaaaaaaaaaaaaaaaaaaaaaaaaaaaaaaa
aaaaaaaaaaaaaaaaaaaaaaaaaaaaaaaaaaaaaaaaaaaaaaaa
aaaaaaaaaaaaaaaaaaaaaaaaaaaaaaaaaaaaaaaaaaaaaaaa
aaaaaaaaaaaaaaaaaaaaaaaaaaaaaaaaaaaaaaaaaaaaaaaa
aaaaaaaaaaaaaaaaaaaaaaaaaaaaaaaaaaaaaaaaaaaaaaaa
aaaaaaaaaaaaaaaaaaaaaaaaaaaaaaaaaaaaaaaaaaaaaaaa
aaaaaaaaaaaaaaaaaaaaaaaaaaaaaaaaaaaaaaaaaaaaaaaa
aaaaaaaaaaaaaaaaaaaaaaaaaaaaaaaaaaaaaaaaaaaaaaaa
aaaaaaaaaaaaaaaaaaaaaaaaaaaaaaaaaaaaaaaaaaaaaaaa
aaaaaaaaaaaaaaaaaaaaaaaaaaaaaaaaaaaaaaaaaaaaaaaa
aaaaaaaaaaaaaaaaaaaaaaaaaaaaaaaaaaaaaaaaaaaaaaaa
aaaaaaaaaaaaaaaaaaaaaaaaaaaaaaaaaaaaaaaaaaaaaaaa
aaaaaaaaaaaaaaaaaaaaaaaaaaaaaaaaaaaaaaaaaaaaaaaa
aaaaaaaaaaaaaaaaaaaaaaaaaaaaaaaaaaaaaaaaaaaaaaaa
aaaaaaaaaaaaaaaaaaaaaaaaaaaaaaaaaaaaaaaaaaaaaaaa
aaaaaaaaaaaaaaaaaaaaaaaaaaaaaaaaaaaaaaaaaaaaaaaa
aaaaaaaaaaaaaaaaaaaaaaaaaaaaaaaaaaaaaaaaaaaaaaaa
aaaaaaaaaaaaaaaaaaaaaaaaaaaaaaaaaaaaaaaaaaaaaaaa
aaaaaaaaaaaaaaaaaaaaaaaaaaaaaaaaaaaaaaaaaaaaaaaa
aaaaaaaaaaaaaaaaaaaaaaaaaaaaaaaaaaaaaaaaaaaaaaaa
aaaaaaaaaaaaaaaaaaaaaaaaaaaaaaaaaaaaaaaaaaaaaaaa
aaaaaaaaaaaaaaaaaaaaaaaaaaaaaaaaaaaaaaaaaaaaaaaa
aaaaaaaaaaaaaaaaaaaaaaaaaaaaaaaaaaaaaaaaaaaaaaaa
aaaaaaaaaaaaaaaaaaaaaaaaaaaaaaaaaaaaaaaaaaaaaaaa
aaaaaaaaaaaaaaaaaaaaaaKqvpaaaaaaaaaaaaaaaaaaaaaa
aaaaaaaaaaaaaaaaaaaaaaKTfpaaaaaaaaaaaaaaaaaaaaaa
aaaaaaaaaaaaaaaaaaaaaaIcchaaaaaaaaaaaaaaaaaaaaaa
aaaaaaaaaaaaaaaaaaaaaaaaaaaaaaaaaaaaaaaaaaaaaaaa
aaaaaaaaaaaaaaaaaaaaaaaaaaaaaaaaaaaaaaaaaaaaaaaa
aaaaaaaaaaaaaaaaaaaaaaaaaaaaaaaaaaaaaaaaaaaaaaaa
aaaaaaaaaaaaaaaaaaaaaaaaaaaaaaaaaaaaaaaaaaaaaaaa
aaaaaaaaaaaaaaaaaaaaaaaaaaaaaaaaaaaaaaaaaaaaaaaa
aaaaaaaaaaaaaaaaaaaaaaaaaaaaaaaaaaaaaaaaaaaaaaaa
aaaaaaaaaaaaaaaaaaaaaaaaaaaaaaaaaaaaaaaaaaaaaaaa
aaaaaaaaaaaaaaaaaaaaaaaaaaaaaaaaaaaaaaaaaaaaaaaa
aaaaaaaaaaaaaaaaaaaaaaaaaaaaaaaaaaaaaaaaaaaaaaaa
aaaaaaaaaaaaaaaaaaaaaaaaaaaaaaaaaaaaaaaaaaaaaaaa
aaaaaaaaaaaaaaaaaaaaaaaaaaaaaaaaaaaaaaaaaaaaaaaa
aaaaaaaaaaaaaaaaaaaaaaaaaaaaaaaaaaaaaaaaaaaaaaaa
aaaaaaaaaaaaaaaaaaaaaaaaaaaaaaaaaaaaaaaaaaaaaaaa
aaaaaaaaaaaaaaaaaaaaaaaaaaaaaaaaaaaaaaaaaaaaaaaa
aaaaaaaaaaaaaaaaaaaaaaaaaaaaaaaaaaaaaaaaaaaaaaaa
aaaaaaaaaaaaaaaaaaaaaaaaaaaaaaaaaaaaaaaaaaaaaaaa
aaaaaaaaaaaaaaaaaaaaaaaaaaaaaaaaaaaaaaaaaaaaaaaa
aaaaaaaaaaaaaaaaaaaaaaaaaaaaaaaaaaaaaaaaaaaaaaaa
aaaaaaaaaaaaaaaaaaaaaaaaaaaaaaaaaaaaaaaaaaaaaaaa
aaaaaaaaaaaaaaaaaaaaaaaaaaaaaaaaaaaaaaaaaaaaaaaa
aaaaaaaaaaaaaaaaaaaaaaaaaaaaaaaaaaaaaaaaaaaaaaaa
aaaaaaaaaaaaaaaaaaaaaaaaaaaaaaaaaaaaaaaaaaaaaaaa
aaaaaaaaaaaaaaaaaaaaaaaaaaaaaaaaaaaaaaaaaaaaaaaa
aaaaaaaaaaaaaaaaaaaaaaaaaaaaaaaaaaaaaaaaaaaaaaaa
aaaaaaaaaaaaaaaaaaaaaaaaaaaaaaaaaaaaaaaaaaaaaaaa
aaaaaaaaaaaaaaaaaaaaaaaaaaaaaaaaaaaaaaaaaaaaaaaa
aaaaaaaaaaaaaaaaaaaaaaaaaaaaaaaaaaaaaaaaaaaaaaaa
aaaaaaaaaaaaaaaaaaaaaaaaaaaaaaaaaaaaaaaaaaaaaaaa
aaaaaaaaaaaaaaaaaaaaaaaaaaaaaaaaaaaaaaaaaaaaaaaa
aaaaaaaaaaaaaaaaaaaaaaaaaaaaaaaaaaaaaaaaaaaaaaaa
aaaaaaaaaaaaaaaaaaaaaaaaaaaaaaaaaaaaaaaaaaaaaaaa
aaaaaaaaaaaaaaaaaaaaaaaaaaaaaaaaaaaaaaaaaaaaaaaa
aaaaaaaaaaaaaaaaaaaaaaaaaaaaaaaaaaaaaaaaaaaaaaaa
aaaaaaaaaaaaaaaaaaaaaaaaaaaaaaaaaaaaaaaaaaaaaaaa
aaaaaaaaaaaaaaaaaaaaaaaaaaaaaaaaaaaaaaaaaaaaaaaa
aaaaaaaaaaaaaaaaaaaaaaaaaaaaaaaaaaaaaaaaaaaaaaaa
aaaaaaaaaaaaaaaaaaaaaaaaaaaaaaaaaaaaaaaaaaaaaaaa
aaaaaaaaaaaaaaaaaaaaaaaaaaaaaaaaaaaaaaaaaaaaaaaa
aaaaaaaaaaaaaaaaaaaaaaaaaaaaaaaaaaaaaaaaaaaaaaaa
aaaaaaaaaaaaaaaaaaaaaaaaaaaaaaaaaaaaaaaaaaaaaaaa
aaaaaaaaaaaaaaaaaaaaaaaaaaaaaaaaaaaaaaaaaaaaaaaa
aaaaaaaaaaaaaaaaaaaaaaaaaaaaaaaaaaaaaaaaaaaaaaaa
aaaaaaaaaaaaaaaaaaaaaaaaaaaaaaaaaaaaaaaaaaaaaaaa
aaaaaaaaaaaaaaaaaaaaaaaaaaaaaaaaaaaaaaaaaaaaaaaa
aaaaaaaaaaaaaaaaaaaaaaaaaaaaaaaaaaaaaaaaaaaaaaaa
aaaaaaaaaaaaaaaaaaaaaaaaaaaaaaaaaaaaaaaaaaaaaaaa
aaaaaaaaaaaaaaaaaaaaaaaaaaaaaaaaaaaaaaaaaaaaaaaa
aaaaaaaaaaaaaaaaaaaaaaaaaaaaaaaaaaaaaaaaaaaaaaaa
aaaaaaaaaaaaaaaaaaaaaaaaaaaaaaaaaaaaaaaaaaaaaaaa
aaaaaaaaaaaaaaaaaaaaaaaaaaaaaaaaaaaaaaaaaaaaaaaa
aaaaaaaaaaaaaaaaaaaaaaaaaaaaaaaaaaaaaaaaaaaaaaaa
"}
(1,1,2) = {"
aaaaaaaaaaaaaaaaaaaaaaaaaaaaaaaaaaaaaaaaaaaaaaaa
aaaaaaaaaaaaaaaaaaaaaaaaaaaaaaaaaaaaaaaaaaaaaaaa
aaaaaaaaaaaaaaaaaaaaaaaaaaaaaaaaaaaaaaaaaaaaaaaa
aaaaaaaaaaaaaaaaaaaaaaaaaaaaaaaaaaaaaaaaaaaaaaaa
aaaaaaaaaaaaaaaaaaaaaaaaaaaaaaaaaaaaaaaaaaaaaaaa
aaaaaaaaaaaaaaaaaaaaaaaaaaaaaaaaaaaaaaaaaaaaaaaa
aaaaaaaaaaaaaaaaaaaaaaaaaaaaaaaaaaaaaaaaaaaaaaaa
aaaaaaaaaaaaaaaaaaaaaaaaaaaaaaaaaaaaaaaaaaaaaaaa
aaaaaaaaaaaaaaaaaaaaaaaaaaaaaaaaaaaaaaaaaaaaaaaa
aaaaaaaaaaaaaaaaaaaaaaaaaaaaaaaaaaaaaaaaaaaaaaaa
aaaaaaaaaaaaaaaaaaaaaaaaaaaaaaaaaaaaaaaaaaaaaaaa
aaaaaaaaaaaaaaaaaaaaaaaaaaaaaaaaaaaaaaaaaaaaaaaa
aaaaaaaaaaaaaaaaaaaaaaaaaaaaaaaaaaaaaaaaaaaaaaaa
aaaaaaaaaaaaaaaaaaaaaaaaaaaaaaaaaaaaaaaaaaaaaaaa
aaaaaaaaaaaaaaaaaaaaaaaaaaaaaaaaaaaaaaaaaaaaaaaa
aaaaaaaaaaaaaaaaaaaaaaaaaaaaaaaaaaaaaaaaaaaaaaaa
aaaaaaaaaaaaaaaaaaaaaaaaaaaaaaaaaaaaaaaaaaaaaaaa
aaaaaaaaaaaaaaaaaaaaaaaaaaaaaaaaaaaaaaaaaaaaaaaa
aaaaaaaaaaaaaaaaaaaaaaaaaaaaaaaaaaaaaaaaaaaaaaaa
aaaaaaaaaaaaaaaaaaaaaaaaaaaaaaaaaaaaaaaaaaaaaaaa
aaaaaaaaaaaaaaaaaaaaaaaaaaaaaaaaaaaaaaaaaaaaaaaa
aaaaaaaaaaaaaaaaaaaaaaaaaaaaaaaaaaaaaaaaaaaaaaaa
aaaaaaaaaaaaaaaaaaaaaaaaaaaaaaaaaaaaaaaaaaaaaaaa
aaaaaaaaaaaaaaaaaaaaaaaaaaaaaaaaaaaaaaaaaaaaaaaa
aaaaaaaaaaaaaaaaaaaaaaaaaaaaaaaaaaaaaaaaaaaaaaaa
aaaaaaaaaaaaaaaaaaaaaaaaaaaaaaaaaaaaaaaaaaaaaaaa
aaaaaaaaaaaaaaaaaaaaaaaaaaaaaaaaaaaaaaaaaaaaaaaa
aaaaaaaaaaaaaaaaaaaaaaaaaaaaaaaaaaaaaaaaaaaaaaaa
aaaaaaaaaaaaaaaaaaaaaaaaaaaaaaaaaaaaaaaaaaaaaaaa
aaaaaaaaaaaaaaaaaaaaaaaaaaaaaaaaaaaaaaaaaaaaaaaa
aaaaaaaaaaMaaaaaaaaaaaaaaaaaaaaaaaaaaaaaaaaaaaaa
aaaaaaaaaaMaaaaaaaaaaaaaaaaaaaaaaaaaaaaaaaaaaaaa
aaaaaaaaaaMaaaaaaaaaaaaaaaaaaaaaaaaaaaaaaaaaaaaa
aaaaaaaaaaMaaaaaaaaaaaaaaaaaaaaaaaaaaaaaaaaaaaaa
aaaaaaaaaaMaaaaaaaaaaaaaaaaaaaaaaaaaaaaaaaaaaaaa
aaaaaaaaaaMaaaaaaaaaaaaaaaaaaaaaaaaaaaaaaaaaaaaa
aaaaaaaaaaMaaaaaaaaaaaaaaaaaaaaaaaaaaaaaaaaaaaaa
aaaaaaaaaaMaaaaaaaaaaaaaaaaaaaaaaaaaaaaaaaaaaaaa
aaaaaaaaaaMaaaaaaaaaaaaaaaaaaaaaaaaaaaaaaaaaaaaa
aaaaaaaaaaMaaaaaaaaaaaaaaaaaaaaaaaaaaaaaaaaaaaaa
aaaaaaaaaaMaaaaaaaaaaaaaaaaaaaaaaaaaaaaaaaaaaaaa
aaaaaaaaaaMaaaaaaaaaaaaaaaaaaaaaaaaaaaaaaaaaaaaa
aaaaaaaaaaMaaaaaaaaaaaaaaaaaaaaaaaaaaaaaaaaaaaaa
aaaaaaaaaaMaaaaaaaaaaaaaaaaaaaaaaaaaaaaaaaaaaaaa
aaaaaaaaaaMaaaaaaaaaaaaaaaaaaaaaaaaaaaaaaaaaaaaa
aaaaaaaaaaMaaaaaaaaaaaaaaaaaaaaaaaaaaaaaaaaaaaaa
aaaaaaaaaaMaaaaaaaaaaaaaaaaaaaaaaaaaaaaaaaaaaaaa
aaaaaaaaaaMaaaaaaaaaaaaaaaaaaaaaaaaaaaaaaaaaaaaa
aaaaaaaaaaMaaaaaaaaaaaaaaaaaaaaaaaaaaaaaaaaaaaaa
aaaaaaaaaaMaaaaaaaaaaaaaaaaaaaaaaaaaaaaaaaaaaaaa
aaaaaaaaaaMaaaaaaaaaaaaaaaaaaaaaaaaaaaaaaaaaaaaa
aaaaaaaaaaMaaaaaaaaaaaaaaaaaaaaaaaaaaaaaaaaaaaaa
aaaaaaaaaaMaaaaaaaaaaaaaaaaaaaaaaaaaaaaaaaaaaaaa
aaaaaaaaaaMaaaaaaaaaaaaaaaaaaaaaaaaaaaaaaaaaaaaa
aaaaaaaaaaMaaaaaaaaaaaaaaaaaaaaaaaaaaaaaaaaaaaaa
aaaaaaaaaaMaaaaaaaaaaaaaaaaaaaaaaaaaaaaaaaaaaaaa
aaaaaaaaaaMaaaaaaaaaaaaaaaaaaaaaaaaaaaaaaaaaaaaa
aaaaaaaaaaMaaaaaaaaaaaaaaaaaaaaaaaaaaaaaaaaaaaaa
aaaaaaaaaaMaaaaaaaaaaaaaaaaaaaaaaaaaaaaaaaaaaaaa
aaaaaaaaaaMaaaaaaaaaaaaaaaaaaaaaaaaaaaaaaaaaaaaa
aaaaaaaaaaMaaaaaaaaaaaaaaaaaaaaaaaaaaaaaaaaaaaaa
aaaaaaaaaaMaaaaaaaaaaaaaaaaaaaaaaaaaaaaaaaaaaaaa
aaaaaaaaaaMaaaaaaaaaaaaaaaaaaaaaaaaaaaaaaaaaaaaa
aaaaaaaaaaMbbbbbbbbbbbbmmbbbbbbbtbbbbaaaaaaaaaaa
aaaaaaaaaaMmmmmmmmmmmmmmmmmmmmmmmmmmmaaaaaaaaaaa
aaaaaaaaaaMmmmmmmmmmmmmmmmmmmmmmmmmmmaaaaaaaaaaa
aaaaaaaaaaMmmmmmmmmmmmmmmmmmmmmmmmmmmaaaaaaaaaaa
aaaaaaaaaaMmmmmmmmmmmmmmmmmmmmmmmmmmmaaaaaaaaaaa
aaaaaaaaaaMmmmmmmmmmmmmmmmmmmmmmmmmmmaaaaaaaaaaa
aaaaaaaaaaMmmmmmmmmmmmmmmmmmmmmmmmmmmaaaaaaaaaaa
aaaaaaaaaaMmmmmmmmmmmmmmmmmmmmmmmmmmmaaaaaaaaaaa
aaaaaaaaaaMmmmmmmmmmmmmmmmmmmmmmmmmmmaaaaaaaaaaa
aaaaaaaaaaMmmmmmmmmmmmmmmmmmmmmmmmmmmaaaaaaaaaaa
aaaaaaaaaaMmmmmmmmmmmmmmmmmmmmmmmmmmmaaaaaaaaaaa
aaaaaaaaaaMmmmmmmmmmmmmmmmmmmmmmmmmmmaaaaaaaaaaa
aaaaaaaaaaMmmmmmmmmmmmmmmmmmmmmmmmmmmaaaaaaaaaaa
aaaaaaaaaaMmmmmmmmmmmmmmmmmmmmmmmmmmmaaaaaaaaaaa
aaaaaaaaaaMmmmmmmmmmmmmmmmmmmmmmmmmmmaaaaaaaaaaa
aaaaaaaaaaMmmmmmmmmmmmmmmmmmmmmmmmmmmaaaaaaaaaaa
aaaaaaaaaaMmmmmmmmmmmmmmmmmmmmmmmmmmmaaaaaaaaaaa
aaaaaaaaaaMmmmmmmmmmmmmmmmmmmmmmmmmmmaaaaaaaaaaa
aaaaaaaaaaMmmmmmmmmmmmmmmmmmmmmmmmmmmaaaaaaaaaaa
aaaaaaaaaaMmmmmmmmmmmmmmmmmmmmmmmmmmmaaaaaaaaaaa
aaaaaaaaaaMmmmmmmmmmmmmmmmmmmmmmmmmmmaaaaaaaaaaa
aaaaaaaaaaMmmmmmmmmmmmmmmmmmmmmmmmmmmaaaaaaaaaaa
aaaaaaaaaaMmmmmmmmmmmmmmmmmmmmmmmmmmmaaaaaaaaaaa
aaaaaaaaaaMmmmmmmmmmmmmmmmmmmmmmmmmmmaaaaaaaaaaa
aaaaaaaaaaMmmmmmmmmmmmmmmmmmmmmmmmmmmaaaaaaaaaaa
aaaaaaaaaaMmmmmmmmmmmmmmmmmmmmmmmmmmmaaaaaaaaaaa
aaaaaaaaaaMmmmmmmmmmmmmmmmmmmmmmmmmmmaaaaaaaaaaa
aaaaaaaaaaMmmmmmmmmmmmmmmmmmmmmmmmmmmaaaaaaaaaaa
aaaaaaaaaaMmmmmmmmmmmmmmmmmmmmmmmmmmmaaaaaaaaaaa
aaaaaaaaaaMmmmmmmmmmmmmmmmmmmmmmmmmmmaaaaaaaaaaa
aaaaaaaaaaMmmmmmmmmmmmmmmmmmmmmmmmmmmaaaaaaaaaaa
aaaaaaaaaaMmmmmmmmmmmmmmmmmmmmmmmmmmmaaaaaaaaaaa
aaaaaaaaaaMmmmmmmmmmmmmmmmmmmmmmmmmmmaaaaaaaaaaa
aaaaaaaaaaMmmmmmmmmmmmmmmmmmmmmmmmmmmaaaaaaaaaaa
aaaaaaaaaaMmmmmmmmmmmmmmmmmmmmmmmmmmmaaaaaaaaaaa
aaaaaaaaaaMmmmmmmmmmmmmmmmmmmmmmmmmmmaaaaaaaaaaa
aaaaaaaaaaMmmmmmmmmmmmmmmmmmmmmmmmmmmaaaaaaaaaaa
aaaaaaaaaaMmmmmmmmmmmmmmmmmmmmmmmmmmmaaaaaaaaaaa
aaaaaaaaaaMmmmmmmmmmmmmmmmmmmmmmmmmmmaaaaaaaaaaa
aaaaaaaaaaMmmmmmmmmmmmmmmmmmmmmmmmmmmaaaaaaaaaaa
aaaaaaaaaaMmmmmmmmmmmmmmmmmmmmmmmmmmmaaaaaaaaaaa
aaaaaaaaaaMmmmmmmmmmmmmmmmmmmmmmmmmmmaaaaaaaaaaa
aaaaaaaaaaMmmmmmmmmmmmmmmmmmmmmmmmmmmaaaaaaaaaaa
aaaaaaaaaaMmmmmmmmmmmmmmmmmmmmmmmmmmmaaaaaaaaaaa
aaaaaaaaaaMmmmmmmmmmmmmmmmmmmmmmmmmmmaaaaaaaaaaa
aaaaaaaaaaMmmmmmmmmmmmmmmmmmmmmmmmmmmaaaaaaaaaaa
aaaaaaaaaaMmmmmmmmmmmmmmmmmmmmmmmmmmmaaaaaaaaaaa
aaaaaaaaaaMmmmmmmmmmmmmmmmmmmmmmmmmmmaaaaaaaaaaa
aaaaaaaaaaMmmmmmmmmmmmmmmmmmmmmmmmmmmaaaaaaaaaaa
aaaaaaaaaaMmmmmmmmmmmmmmmmmmmmmmmmmmmaaaaaaaaaaa
aaaaaaaaaaMmmmmmmmmmmmmmmmmmmmmmmmmmmaaaaaaaaaaa
aaaaaaaaaaMmmmmmmmmmmmmmmmmmmmmmmmmmmaaaaaaaaaaa
aaaaaaaaaaMmmmmmmmmmmmmmmmmmmmmmmmmmmaaaaaaaaaaa
aaaaaaaaaaMmmmmmmmmmmmmmmmmmmmmmmmmmmaaaaaaaaaaa
aaaaaaaaaaMmmmmmmmmmmmmmmmmmmmmmmmmmmaaaaaaaaaaa
aaaaaaaaaaMmmmmmmmmmmmmmmmmmmmmmmmmmmaaaaaaaaaaa
aaaaaaaaaaMmmmmmmmmmmmmmmmmmmmmmmmmmmaaaaaaaaaaa
aaaaaaaaaaMmmmmmmmmEEEEEEEEEEmmmmmmmmaaaaaaaaaaa
aaaaaaaaaaMmmmmmmHHiiiiiiiiiiHHmmmmmmaaaaaaaaaaa
aaaaaaaaaaMmmmmmmHHRRRRRRRRRRHHmmmmmmaaaaaaaaaaa
aaaaaaaaaaMmmmmmEjHssssssssssHjEmmmmmaaaaaaaaaaa
aaaaaaaaaaMmmmmmEiHHHHHHHHHHHHiEmmmmmaaaaaaaaaaa
aaaaaaaaaaMmmmmmEiHHHHHHHHHHHHiEmmmmmaaaaaaaaaaa
aaaaaaaaaaMmmmmmEiHsHRHHHHRHsHiEmmmmmaaaaaaaaaaa
aaaaaaaaaaMEQEQEQrHsHRHHHHRHsHiEQEQEQaaaaaaaaaaa
aaaaaaaaaaMmmmmmmHHsHRHHHHRHsHHmmmmmmaaaaaaaaaaa
aaaaaaaaaaMEQEQEQrHsHRHHHHRHsHiEQEQEQaaaaaaaaaaa
aaaaaaaaaaMmmmmmEiHsHRHHHHRHsHiEmmmmmaaaaaaaaaaa
aaaaaaaaaaMmmmmmEiHsHRHHHHRHsHiEmmmmmaaaaaaaaaaa
aaaaaaaaaaMmmmmmEiHHHHHHHHHHHHiEmmmmmaaaaaaaaaaa
aaaaaaaaaaMmmmmmEiHHHHHHHHHHHHiEmmmmmaaaaaaaaaaa
aaaaaaaaaaMmmmmmEjHssssssssssHjEmmmmmaaaaaaaaaaa
aaaaaaaaaaMmmmmmmHHRRRRRRRRRRHHmmmmmmaaaaaaaaaaa
aaaaaaaaaaMmmmmmmHHiiiiiiiiiiHHmmmmmmaaaaaaaaaaa
aaaaaaaaaaMmmmmmmmmEEEEEEEEEEmmmmmmmmaaaaaaaaaaa
aaaaaaaaaaMmmmmmmmmmmmmmmmmmmmmmmmmmmaaaaaaaaaaa
aaaaaaaaaaMmmmmmmmmmmmmmmmmmmmmmmmmmmaaaaaaaaaaa
aaaaaaaaaaMmmmmmmmmmmmmmmmmmmmmmmmmmmaaaaaaaaaaa
aaaaaaaaaaMmmmmmmmmmmmmmmmmmmmmmmmmmmaaaaaaaaaaa
aaaaaaaaaaMmmmmmmmmmmmmmmmmmmmmmmmmmmaaaaaaaaaaa
aaaaaaaaaaMmmmmmmmmmmmmmmmmmmmmmmmmmmaaaaaaaaaaa
aaaaaaaaaaMmmmmmmmmmmmmmmmmmmmmmmmmmmaaaaaaaaaaa
aaaaaaaaaaMmmmmmmmmmmmmmmmmmmmmmmmmmmaaaaaaaaaaa
aaaaaaaaaaMmmmmmmmmmmmmmmmmmmmmmmmmmmaaaaaaaaaaa
aaaaaaaaaaMmmmmmmmmmmmmmmmmmmmmmmmmmmaaaaaaaaaaa
aaaaaaaaaaMmmmmmmmmmmmmmmmmmmmmmmmmmmaaaaaaaaaaa
aaaaaaaaaaMmmmmmmmmmmmmmmmmmmmmmmmmmmaaaaaaaaaaa
aaaaaaaaaaMmmmmmmmmmmmmmmmmmmmmmmmmmmaaaaaaaaaaa
aaaaaaaaaaMmmmmmmmmmmmmmmmmmmmmmmmmmmaaaaaaaaaaa
aaaaaaaaaaMmmmmmmmmmmmmmmmmmmmmmmmmmmaaaaaaaaaaa
aaaaaaaaaaMmmmmmmmmmmmmmmmmmmmmmmmmmmaaaaaaaaaaa
aaaaaaaaaaMmmmmmmmmmmmmmmmmmmmmmmmmmmaaaaaaaaaaa
aaaaaaaaaaMmmmmmmmmmmmmmmmmmmmmmmmmmmaaaaaaaaaaa
aaaaaaaaaaMmmmmmmmmmmmmmmmmmmmmmmmmmmaaaaaaaaaaa
aaaaaaaaaaMmmmmmmmmmmmmmmmmmmmmmmmmmmaaaaaaaaaaa
aaaaaaaaaaMmmmmmmmmmmmmmmmmmmmmmmmmmmaaaaaaaaaaa
aaaaaaaaaaMmmmmmmmmmmmmmmmmmmmmmmmmmmaaaaaaaaaaa
aaaaaaaaaaMmmmmmmmmmmmmmmmmmmmmmmmmmmaaaaaaaaaaa
aaaaaaaaaaMmmmmmmmmmmmmmmmmmmmmmmmmmmaaaaaaaaaaa
aaaaaaaaaaMmmmmmmmmmmmmmmmmmmmmmmmmmmaaaaaaaaaaa
aaaaaaaaaaMmmmmmmmmmmmmmmmmmmmmmmmmmmaaaaaaaaaaa
aaaaaaaaaaMmmmmmmmmmmmmmmmmmmmmmmmmmmaaaaaaaaaaa
aaaaaaaaaaMmmmmmmmmmmmmmmmmmmmmmmmmmmaaaaaaaaaaa
aaaaaaaaaaMmmmmmmmmmmmmmmmmmmmmmmmmmmaaaaaaaaaaa
aaaaaaaaaaMmmmmmmmmmmmmmmmmmmmmmmmmmmaaaaaaaaaaa
aaaaaaaaaaMmmmmmmmmmmmmmmmmmmmmmmmmmmaaaaaaaaaaa
aaaaaaaaaaMmmmmmmmmmmmmmmmmmmmmmmmmmmaaaaaaaaaaa
aaaaaaaaaaMmmmmmmmmmmmmmmmmmmmmmmmmmmaaaaaaaaaaa
aaaaaaaaaaMmmmmmmmmmmmmmmmmmmmmmmmmmmaaaaaaaaaaa
aaaaaaaaaaMmmmmmmmmmmmmmmmmmmmmmmmmmmaaaaaaaaaaa
aaaaaaaaaaMmmmmmmmmmmmmmmmmmmmmmmmmmmaaaaaaaaaaa
aaaaaaaaaaMmmmmmmmmmmmmmmmmmmmmmmmmmmaaaaaaaaaaa
aaaaaaaaaaMmmmmmmmmmmmmmmmmmmmmmmmmmmaaaaaaaaaaa
aaaaaaaaaaMmmmmmmmmmmmmmmmmmmmmmmmmmmaaaaaaaaaaa
aaaaaaaaaaMmmmmmmmmmmmmmmmmmmmmmmmmmmaaaaaaaaaaa
aaaaaaaaaaMmmmmmmmmmmmmmmmmmmmmmmmmmmaaaaaaaaaaa
aaaaaaaaaaMmmmmmmmmmmmmmmmmmmmmmmmmmmaaaaaaaaaaa
aaaaaaaaaaMmmmmmmmmmmmmmmmmmmmmmmmmmmaaaaaaaaaaa
aaaaaaaaaaMmmmmmmmmmmmmmmmmmmmmmmmmmmaaaaaaaaaaa
aaaaaaaaaaMmmmmmmmmmmmmmmmmmmmmmmmmmmaaaaaaaaaaa
aaaaaaaaaaMmmmmmmmmmmmmmmmmmmmmmmmmmmaaaaaaaaaaa
aaaaaaaaaaMmmmmmmmmmmmmmmmmmmmmmmmmmmaaaaaaaaaaa
aaaaaaaaaaMmmmmmmmmmmmmmmmmmmmmmmmmmmaaaaaaaaaaa
aaaaaaaaaaMmmmmmmmmmmmmmmmmmmmmmmmmmmaaaaaaaaaaa
aaaaaaaaaaMmmmmmmmmmmmmmmmmmmmmmmmmmmaaaaaaaaaaa
aaaaaaaaaaMmmmmmmmmmmmmmmmmmmmmmmmmmmaaaaaaaaaaa
aaaaaaaaaaMmmmmmmmmmmmmmmmmmmmmmmmmmmaaaaaaaaaaa
aaaaaaaaaaMttttttttttttmmttttttttttttaaaaaaaaaaa
aaaaaaaaaaMaaaaaaaaaaaaaaaaaaaaaaaaaaaaaaaaaaaaa
aaaaaaaaaaMaaaaaaaaaaaaaaaaaaaaaaaaaaaaaaaaaaaaa
aaaaaaaaaaMaaaaaaaaaaaaaaaaaaaaaaaaaaaaaaaaaaaaa
aaaaaaaaaaMaaaaaaaaaaaaaaaaaaaaaaaaaaaaaaaaaaaaa
aaaaaaaaaaMaaaaaaaaaaaaaaaaaaaaaaaaaaaaaaaaaaaaa
aaaaaaaaaaMaaaaaaaaaaaaaaaaaaaaaaaaaaaaaaaaaaaaa
aaaaaaaaaaMaaaaaaaaaaaaaaaaaaaaaaaaaaaaaaaaaaaaa
aaaaaaaaaaMaaaaaaaaaaaaaaaaaaaaaaaaaaaaaaaaaaaaa
aaaaaaaaaaMaaaaaaaaaaaaaaaaaaaaaaaaaaaaaaaaaaaaa
aaaaaaaaaaMaaaaaaaaaaaaaaaaaaaaaaaaaaaaaaaaaaaaa
aaaaaaaaaaMaaaaaaaaaaaaaaaaaaaaaaaaaaaaaaaaaaaaa
aaaaaaaaaaMaaaaaaaaaaaaaaaaaaaaaaaaaaaaaaaaaaaaa
aaaaaaaaaaMaaaaaaaaaaaaaaaaaaaaaaaaaaaaaaaaaaaaa
aaaaaaaaaaMaaaaaaaaaaaaaaaaaaaaaaaaaaaaaaaaaaaaa
aaaaaaaaaaMaaaaaaaaaaaaaaaaaaaaaaaaaaaaaaaaaaaaa
aaaaaaaaaaMaaaaaaaaaaaaaaaaaaaaaaaaaaaaaaaaaaaaa
aaaaaaaaaaMaaaaaaaaaaaaaaaaaaaaaaaaaaaaaaaaaaaaa
aaaaaaaaaaMaaaaaaaaaaaaaaaaaaaaaaaaaaaaaaaaaaaaa
aaaaaaaaaaMaaaaaaaaaaaaaaaaaaaaaaaaaaaaaaaaaaaaa
aaaaaaaaaaMaaaaaaaaaaaaaaaaaaaaaaaaaaaaaaaaaaaaa
aaaaaaaaaaMaaaaaaaaaaaaaaaaaaaaaaaaaaaaaaaaaaaaa
aaaaaaaaaaMaaaaaaaaaaaaaaaaaaaaaaaaaaaaaaaaaaaaa
aaaaaaaaaaMaaaaaaaaaaaaaaaaaaaaaaaaaaaaaaaaaaaaa
aaaaaaaaaaMaaaaaaaaaaaaaaaaaaaaaaaaaaaaaaaaaaaaa
aaaaaaaaaaMaaaaaaaaaaaaaaaaaaaaaaaaaaaaaaaaaaaaa
aaaaaaaaaaMaaaaaaaaaaaaaaaaaaaaaaaaaaaaaaaaaaaaa
aaaaaaaaaaMaaaaaaaaaaaaaaaaaaaaaaaaaaaaaaaaaaaaa
aaaaaaaaaaMaaaaaaaaaaaaaaaaaaaaaaaaaaaaaaaaaaaaa
aaaaaaaaaaMaaaaaaaaaaaaaaaaaaaaaaaaaaaaaaaaaaaaa
aaaaaaaaaaMaaaaaaaaaaaaaaaaaaaaaaaaaaaaaaaaaaaaa
aaaaaaaaaaMaaaaaaaaaaaaaaaaaaaaaaaaaaaaaaaaaaaaa
aaaaaaaaaaMaaaaaaaaaaaaaaaaaaaaaaaaaaaaaaaaaaaaa
aaaaaaaaaaMaaaaaaaaaaaaaaaaaaaaaaaaaaaaaaaaaaaaa
aaaaaaaaaaaaaaaaaaaaaaaaaaaaaaaaaaaaaaaaaaaaaaaa
aaaaaaaaaaaaaaaaaaaaaaaaaaaaaaaaaaaaaaaaaaaaaaaa
aaaaaaaaaaaaaaaaaaaaaaaaaaaaaaaaaaaaaaaaaaaaaaaa
aaaaaaaaaaaaaaaaaaaaaaaaaaaaaaaaaaaaaaaaaaaaaaaa
aaaaaaaaaaaaaaaaaaaaaaaaaaaaaaaaaaaaaaaaaaaaaaaa
aaaaaaaaaaaaaaaaaaaaaaaaaaaaaaaaaaaaaaaaaaaaaaaa
aaaaaaaaaaaaaaaaaaaaaaaaaaaaaaaaaaaaaaaaaaaaaaaa
aaaaaaaaaaaaaaaaaaaaaaaaaaaaaaaaaaaaaaaaaaaaaaaa
aaaaaaaaaaaaaaaaaaaaaaaaaaaaaaaaaaaaaaaaaaaaaaaa
aaaaaaaaaaaaaaaaaaaaaaaaaaaaaaaaaaaaaaaaaaaaaaaa
aaaaaaaaaaaaaaaaaaaaaaaaaaaaaaaaaaaaaaaaaaaaaaaa
aaaaaaaaaaaaaaaaaaaaaaaaaaaaaaaaaaaaaaaaaaaaaaaa
aaaaaaaaaaaaaaaaaaaaaaaaaaaaaaaaaaaaaaaaaaaaaaaa
aaaaaaaaaaaaaaaaaaaaaaaaaaaaaaaaaaaaaaaaaaaaaaaa
aaaaaaaaaaaaaaaaaaaaaaaaaaaaaaaaaaaaaaaaaaaaaaaa
aaaaaaaaaaaaaaaaaaaaaaaaaaaaaaaaaaaaaaaaaaaaaaaa
aaaaaaaaaaaaaaaaaaaaaaaaaaaaaaaaaaaaaaaaaaaaaaaa
aaaaaaaaaaaaaaaaaaaaaaaaaaaaaaaaaaaaaaaaaaaaaaaa
aaaaaaaaaaaaaaaaaaaaaaaaaaaaaaaaaaaaaaaaaaaaaaaa
aaaaaaaaaaaaaaaaaaaaaaaaaaaaaaaaaaaaaaaaaaaaaaaa
aaaaaaaaaaaaaaaaaaaaaaaaaaaaaaaaaaaaaaaaaaaaaaaa
aaaaaaaaaaaaaaaaaaaaaaaaaaaaaaaaaaaaaaaaaaaaaaaa
aaaaaaaaaaaaaaaaaaaaaaaaaaaaaaaaaaaaaaaaaaaaaaaa
aaaaaaaaaaaaaaaaaaaaaaaaaaaaaaaaaaaaaaaaaaaaaaaa
"}
